CDDDDDCCCCCDCDDDDCDDDCCCD
BJJJJFFFFFFFFFFFFFFFFFFFA
BJJKJFFFFEEPFEEFEEFIILLIB
AKKJJJKMMEEEMMMEEEMMMKLIB
BJJJNDDDDDMMMMMDDDDDNILIA
AKKJJMMGGHGMUHHHGMMLLLIIB
BJJJMMHHGHGMXGGMVMMIILLIA
AKKKJHHGGHHMMZMHGLLIIILIB
BRKJNEEEEEEEEEEEEEEENILLA
AIIIFFFFFFFFFFFFFFFFILLIB
BLLIFFFFEEEEEEEEFEFLLIIIB
BFFFFFFFFFFFEEEFFFEEFFFFA
BDDCCCCDCCCDCDCDCDDDDDCDA